"AÑO","PROVINCIA","CANTON","ASESINATO","FEMICIDIO","HOMICIDIO","SICARIATO","TOTAL"
"2023","AZUAY","CAMILO PONCE ENRIQUEZ","44","1","10","0","55"
"2023","AZUAY","CHORDELEG","0","0","0","0","0"
"2023","AZUAY","CUENCA","63","13","34","0","110"
"2023","AZUAY","EL PAN","0","0","1","0","1"
"2023","AZUAY","GIRON","0","0","1","0","1"
"2023","AZUAY","GUACHAPALA","0","0","0","0","0"
"2023","AZUAY","GUALACEO","2","1","1","0","4"
"2023","AZUAY","NABON","0","1","2","0","3"
"2023","AZUAY","OÑA","0","0","0","0","0"
"2023","AZUAY","PAUTE","2","0","0","0","2"
"2023","AZUAY","PUCARA","1","0","1","0","2"
"2023","AZUAY","SAN FERNANDO","1","0","0","0","1"
"2023","AZUAY","SANTA ISABEL","4","1","1","0","6"
"2023","AZUAY","SEVILLA DE ORO","0","0","1","0","1"
"2023","AZUAY","SIGSIG","1","0","0","0","1"
"2023","BOLÍVAR","CALUMA","2","2","0","1","5"
"2023","BOLÍVAR","CHILLANES","5","1","0","0","6"
"2023","BOLÍVAR","CHIMBO","2","0","0","0","2"
"2023","BOLÍVAR","ECHEANDIA","0","0","0","2","2"
"2023","BOLÍVAR","GUARANDA","17","0","0","0","17"
"2023","BOLÍVAR","LAS NAVES","2","0","0","0","2"
"2023","BOLÍVAR","SAN MIGUEL DE BOLIVAR","3","0","1","0","4"
"2023","CAÑAR","AZOGUES","21","1","0","0","22"
"2023","CAÑAR","BIBLIAN","2","1","1","0","4"
"2023","CAÑAR","CANAR","5","1","2","0","8"
"2023","CAÑAR","DELEG","1","0","0","0","1"
"2023","CAÑAR","EL TAMBO","3","0","1","0","4"
"2023","CAÑAR","LA TRONCAL","123","2","8","1","134"
"2023","CAÑAR","SUSCAL","0","0","0","0","0"
"2023","CARCHI","BOLIVAR","1","0","0","0","1"
"2023","CARCHI","ESPEJO","1","1","1","0","3"
"2023","CARCHI","MIRA","2","0","1","0","3"
"2023","CARCHI","MONTUFAR","2","3","1","0","6"
"2023","CARCHI","SAN PEDRO DE HUACA","1","0","0","0","1"
"2023","CARCHI","TULCAN","12","4","6","0","22"
"2023","CHIMBORAZO","ALAUSI","4","0","0","0","4"
"2023","CHIMBORAZO","CHAMBO","0","0","1","0","1"
"2023","CHIMBORAZO","CHUNCHI","0","0","1","0","1"
"2023","CHIMBORAZO","COLTA","1","0","2","0","3"
"2023","CHIMBORAZO","CUMANDA","13","0","1","0","14"
"2023","CHIMBORAZO","GUAMOTE","0","0","1","0","1"
"2023","CHIMBORAZO","GUANO","3","0","4","0","7"
"2023","CHIMBORAZO","PALLATANGA","1","0","0","0","1"
"2023","CHIMBORAZO","PENIPE","0","0","0","0","0"
"2023","CHIMBORAZO","RIOBAMBA","36","4","2","1","43"
"2023","COTOPAXI","LA MANA","17","2","2","0","21"
"2023","COTOPAXI","LATACUNGA","55","11","16","1","83"
"2023","COTOPAXI","PANGUA","4","0","1","0","5"
"2023","COTOPAXI","PUJILI","3","1","2","0","6"
"2023","COTOPAXI","SALCEDO","10","5","2","0","17"
"2023","COTOPAXI","SAQUISILI","1","3","0","0","4"
"2023","COTOPAXI","SIGCHOS","2","0","0","0","2"
"2023","EL ORO","ARENILLAS","49","0","6","1","7"
"2023","EL ORO","ATAHUALPA","1","0","0","0","0"
"2023","EL ORO","BALSAS","2","0","0","0","0"
"2023","EL ORO","CHILLA","1","0","0","0","0"
"2023","EL ORO","EL GUABO","128","3","6","7","16"
"2023","EL ORO","HUAQUILLAS","52","4","6","1","11"
"2023","EL ORO","LAS LAJAS","2","0","0","0","0"
"2023","EL ORO","MACHALA","257","6","27","4","37"
"2023","EL ORO","MARCABELI","0","0","0","0","0"
"2023","EL ORO","PASAJE","107","4","6","2","12"
"2023","EL ORO","PINAS","6","0","2","0","2"
"2023","EL ORO","PORTOVELO","10","1","2","0","3"
"2023","EL ORO","SANTA ROSA","59","2","8","0","10"
"2023","EL ORO","ZARUMA","5","0","0","0","0"
"2023","ESMERALDAS","ATACAMES","61","2","3","0","66"
"2023","ESMERALDAS","ELOY ALFARO","32","1","2","0","35"
"2023","ESMERALDAS","ESMERALDAS","334","6","24","5","369"
"2023","ESMERALDAS","MUISNE","15","0","3","0","18"
"2023","ESMERALDAS","QUININDE","97","2","11","0","110"
"2023","ESMERALDAS","RIOVERDE","28","0","5","0","33"
"2023","ESMERALDAS","SAN LORENZO","107","1","8","0","116"
"2023","GALAPAGOS","ISABELA","0","0","0","0","0"
"2023","GALAPAGOS","SAN CRISTOBAL","0","0","0","0","0"
"2023","GALAPAGOS","SANTA CRUZ","0","1","0","0","1"
"2023","GUAYAS","ALFREDO BAQUERIZO MORENO (JUJAN)","31","3","0","0","34"
"2023","GUAYAS","BALAO","50","0","4","0","54"
"2023","GUAYAS","BALZAR","91","2","0","2","95"
"2023","GUAYAS","COLIMES","19","2","0","0","21"
"2023","GUAYAS","CORONEL MARCELINO MARIDUENA","10","1","1","0","12"
"2023","GUAYAS","DAULE","131","4","2","10","147"
"2023","GUAYAS","DURAN","279","6","5","2","292"
"2023","GUAYAS","EL EMPALME","90","2","2","1","95"
"2023","GUAYAS","EL TRIUNFO","81","5","3","2","91"
"2023","GUAYAS","GENERAL ANTONIO ELIZALDE","5","0","0","0","5"
"2023","GUAYAS","GUAYAQUIL","886","29","97","4","1,016"
"2023","GUAYAS","ISIDRO AYORA","22","0","1","0","23"
"2023","GUAYAS","LOMAS DE SARGENTILLO","11","0","0","1","12"
"2023","GUAYAS","MILAGRO","197","7","8","3","215"
"2023","GUAYAS","NARANJAL","153","1","9","0","163"
"2023","GUAYAS","NARANJITO","22","1","0","0","23"
"2023","GUAYAS","NOBOL","22","2","0","2","26"
"2023","GUAYAS","PALESTINA","73","1","0","2","76"
"2023","GUAYAS","PEDRO CARBO","38","2","1","0","41"
"2023","GUAYAS","PLAYAS","51","0","0","0","51"
"2023","GUAYAS","SALITRE (URBINA JADO)","22","2","0","2","26"
"2023","GUAYAS","SAMBORONDON","56","3","0","0","59"
"2023","GUAYAS","SAN JACINTO DE YAGUACHI","100","3","2","0","105"
"2023","GUAYAS","SANTA LUCIA","21","0","0","0","21"
"2023","GUAYAS","SIMON BOLIVAR","18","1","1","0","20"
"2023","IMBABURA","ANTONIO ANTE","5","0","3","0","8"
"2023","IMBABURA","COTACACHI","6","3","4","0","13"
"2023","IMBABURA","IBARRA","10","7","16","1","34"
"2023","IMBABURA","OTAVALO","10","3","7","0","20"
"2023","IMBABURA","PIMAMPIRO","2","0","1","0","3"
"2023","IMBABURA","SAN MIGUEL DE URCUQUI","6","0","0","0","6"
"2023","LOJA","CALVAS","2","0","0","0","2"
"2023","LOJA","CATAMAYO","7","0","2","1","10"
"2023","LOJA","CELICA","0","0","1","0","1"
"2023","LOJA","CHAGUARPAMBA","1","0","1","0","2"
"2023","LOJA","ESPINDOLA","0","0","0","0","0"
"2023","LOJA","GONZANAMA","1","1","0","0","2"
"2023","LOJA","LOJA","22","5","19","0","46"
"2023","LOJA","MACARA","5","1","0","0","6"
"2023","LOJA","OLMEDO","2","0","1","0","3"
"2023","LOJA","PALTAS","0","0","1","0","1"
"2023","LOJA","PINDAL","1","0","0","0","1"
"2023","LOJA","PUYANGO","1","0","0","0","1"
"2023","LOJA","QUILANGA","0","0","0","0","0"
"2023","LOJA","SARAGURO","0","2","1","0","3"
"2023","LOJA","SOZORANGA","0","0","0","0","0"
"2023","LOJA","ZAPOTILLO","3","0","0","0","3"
"2023","LOS RÍOS","BABA","36","1","6","0","43"
"2023","LOS RÍOS","BABAHOYO","160","4","25","0","189"
"2023","LOS RÍOS","BUENA FE","82","1","14","0","97"
"2023","LOS RÍOS","MOCACHE","34","1","3","0","38"
"2023","LOS RÍOS","MONTALVO","6","0","2","0","8"
"2023","LOS RÍOS","PALENQUE","20","0","1","0","21"
"2023","LOS RÍOS","PUEBLOVIEJO","262","0","1","1","264"
"2023","LOS RÍOS","QUEVEDO","77","6","26","4","113"
"2023","LOS RÍOS","QUINSALOMA","24","2","6","1","33"
"2023","LOS RÍOS","URDANETA","34","1","5","3","43"
"2023","LOS RÍOS","VALENCIA","38","0","4","4","46"
"2023","LOS RÍOS","VENTANAS","106","0","10","0","116"
"2023","LOS RÍOS","VINCES","61","5","5","5","76"
"2023","MANABÍ","24 DE MAYO","11","2","1","0","14"
"2023","MANABÍ","BOLIVAR","114","2","1","0","117"
"2023","MANABÍ","CHONE","20","4","2","2","28"
"2023","MANABÍ","EL CARMEN","80","1","6","0","87"
"2023","MANABÍ","FLAVIO ALFARO","17","1","2","1","21"
"2023","MANABÍ","JAMA","8","0","2","0","10"
"2023","MANABÍ","JARAMIJO","25","1","0","1","27"
"2023","MANABÍ","JIPIJAPA","22","3","0","0","25"
"2023","MANABÍ","JUNIN","12","0","0","0","12"
"2023","MANABÍ","MANTA","194","3","8","6","211"
"2023","MANABÍ","MONTECRISTI","66","3","3","1","73"
"2023","MANABÍ","OLMEDO","0","","0","0","0"
"2023","MANABÍ","PAJAN","20","1","2","0","23"
"2023","MANABÍ","PEDERNALES","29","2","8","0","39"
"2023","MANABÍ","PICHINCHA","9","2","0","0","11"
"2023","MANABÍ","PORTOVIEJO","190","1","8","5","204"
"2023","MANABÍ","PUERTO LOPEZ","17","0","2","0","19"
"2023","MANABÍ","ROCAFUERTE","9","1","1","0","11"
"2023","MANABÍ","SAN VICENTE","32","0","1","0","33"
"2023","MANABÍ","SANTA ANA","28","0","1","0","29"
"2023","MANABÍ","SUCRE","62","1","0","1","64"
"2023","MANABÍ","TOSAGUA","27","3","0","0","30"
"2023","MORONA SANTIAGO","GUALAQUIZA","2","1","2","0","5"
"2023","MORONA SANTIAGO","HUAMBOYA","1","0","1","0","2"
"2023","MORONA SANTIAGO","LIMON INDANZA","2","0","0","0","2"
"2023","MORONA SANTIAGO","LOGRONO","0","1","0","0","1"
"2023","MORONA SANTIAGO","MORONA","10","1","3","1","15"
"2023","MORONA SANTIAGO","PABLO SEXTO","0","0","0","0","0"
"2023","MORONA SANTIAGO","PALORA","5","0","1","0","6"
"2023","MORONA SANTIAGO","SAN JUAN BOSCO","0","0","0","0","0"
"2023","MORONA SANTIAGO","SANTIAGO","0","0","1","0","1"
"2023","MORONA SANTIAGO","SUCUA","7","0","3","0","10"
"2023","MORONA SANTIAGO","TAISHA","2","2","1","0","5"
"2023","MORONA SANTIAGO","TIWINTZA","0","0","0","0","0"
"2023","NAPO","ARCHIDONA","5","1","1","0","7"
"2023","NAPO","CARLOS JULIO AROSEMENA TOLA","1","0","1","0","2"
"2023","NAPO","EL CHACO","0","0","0","0","0"
"2023","NAPO","QUIJOS","0","0","1","0","1"
"2023","NAPO","TENA","18","4","3","0","25"
"2023","ORELLANA","AGUARICO","0","0","0","0","0"
"2023","ORELLANA","LA JOYA DE LOS SACHAS","24","1","3","0","28"
"2023","ORELLANA","LORETO","6","1","3","0","10"
"2023","ORELLANA","ORELLANA","31","4","2","0","37"
"2023","PASTAZA","ARAJUNO","1","0","1","0","2"
"2023","PASTAZA","MERA","5","0","1","0","6"
"2023","PASTAZA","PASTAZA","33","2","4","0","39"
"2023","PASTAZA","SANTA CLARA","1","0","0","0","1"
"2023","PICHINCHA","CAYAMBE","6","4","10","1","21"
"2023","PICHINCHA","MEJIA","10","1","7","0","18"
"2023","PICHINCHA","PEDRO MONCAYO","7","4","4","0","15"
"2023","PICHINCHA","PEDRO VICENTE MALDONADO","1","0","0","0","1"
"2023","PICHINCHA","PUERTO QUITO","11","0","2","0","13"
"2023","PICHINCHA","QUITO","167","39","469","1","676"
"2023","PICHINCHA","RUMINAHUI","6","6","4","2","18"
"2023","PICHINCHA","SAN MIGUEL DE LOS BANCOS","7","3","0","0","10"
"2023","SANTA ELENA","LA LIBERTAD","104","3","3","0","110"
"2023","SANTA ELENA","SALINAS","72","0","2","3","77"
"2023","SANTA ELENA","SANTA ELENA","78","6","1","0","85"
"2023","SANTO DOMINGO DE LOS TSÁCHILAS","LA CONCORDIA","38","1","14","0","53"
"2023","SANTO DOMINGO DE LOS TSÁCHILAS","SANTO DOMINGO","213","1","60","0","274"
"2023","SUCUMBÍOS","CASCALES","6","1","0","0","7"
"2023","SUCUMBÍOS","CUYABENO","5","1","0","0","6"
"2023","SUCUMBÍOS","GONZALO PIZARRO","0","1","0","0","1"
"2023","SUCUMBÍOS","LAGO AGRIO","125","3","1","0","129"
"2023","SUCUMBÍOS","PUTUMAYO","10","1","0","0","11"
"2023","SUCUMBÍOS","SHUSHUFINDI","29","6","0","0","35"
"2023","SUCUMBÍOS","SUCUMBIOS","0","0","0","0","0"
"2023","TUNGURAHUA","AMBATO","68","9","18","0","95"
"2023","TUNGURAHUA","BAÑOS DE AGUA SANTA","7","0","0","0","7"
"2023","TUNGURAHUA","CEVALLOS","2","0","0","0","2"
"2023","TUNGURAHUA","MOCHA","0","1","0","0","1"
"2023","TUNGURAHUA","PATATE","0","0","0","0","0"
"2023","TUNGURAHUA","QUERO","0","0","1","0","1"
"2023","TUNGURAHUA","SAN PEDRO DE PELILEO","6","1","1","0","8"
"2023","TUNGURAHUA","SANTIAGO DE PILLARO","4","0","1","0","5"
"2023","TUNGURAHUA","TISALEO","2","0","0","0","2"
"2023","ZAMORA CHINCHIPE","CENTINELA DEL CONDOR","0","1","1","0","2"
"2023","ZAMORA CHINCHIPE","CHINCHIPE","1","0","0","0","1"
"2023","ZAMORA CHINCHIPE","EL PANGUI","2","1","0","0","3"
"2023","ZAMORA CHINCHIPE","NANGARITZA","3","0","0","0","3"
"2023","ZAMORA CHINCHIPE","PALANDA","0","0","0","0","0"
"2023","ZAMORA CHINCHIPE","PAQUISHA","5","0","1","0","6"
"2023","ZAMORA CHINCHIPE","TACUAMBI","0","0","0","0","0"
"2023","ZAMORA CHINCHIPE","YANTZAZA","3","2","4","0","9"
"2023","ZAMORA CHINCHIPE","ZAMORA","0","1","3","0","4"
"2023","ZONAS NO DELIMITADAS","EL PIEDRERO","86","0","5","0","91"
"2023","ZONAS NO DELIMITADAS","LAS GOLONDRINAS","2","0","0","0","2"
"2023","ZONAS NO DELIMITADAS","MANGA DEL CURA","16","1","1","0","18"
"2023",".TOTAL","","7,577","359","1,222","102","8,581"
"2022","AZUAY","CAMILO PONCE ENRIQUEZ","21","0","1","0","22"
"2022","AZUAY","CHORDELEG","0","0","0","0","0"
"2022","AZUAY","CUENCA","33","5","9","0","47"
"2022","AZUAY","EL PAN","0","0","0","0","0"
"2022","AZUAY","GIRON","0","0","0","0","0"
"2022","AZUAY","GUACHAPALA","0","0","0","0","0"
"2022","AZUAY","GUALACEO","1","1","0","0","2"
"2022","AZUAY","NABON","0","1","0","0","1"
"2022","AZUAY","OÑA","0","0","0","0","0"
"2022","AZUAY","PAUTE","1","0","0","0","1"
"2022","AZUAY","PUCARA","1","0","0","0","1"
"2022","AZUAY","SAN FERNANDO","0","0","0","0","0"
"2022","AZUAY","SANTA ISABEL","0","0","0","0","0"
"2022","AZUAY","SEVILLA DE ORO","0","0","0","0","0"
"2022","AZUAY","SIGSIG","0","0","0","0","0"
"2022","BOLÍVAR","CALUMA","0","1","0","1","2"
"2022","BOLÍVAR","CHILLANES","0","0","0","0","0"
"2022","BOLÍVAR","CHIMBO","0","0","1","0","1"
"2022","BOLÍVAR","ECHEANDIA","0","0","0","0","0"
"2022","BOLÍVAR","GUARANDA","6","1","1","0","8"
"2022","BOLÍVAR","LAS NAVES","0","0","0","0","0"
"2022","BOLÍVAR","SAN MIGUEL DE BOLIVAR","0","0","1","0","1"
"2022","CAÑAR","AZOGUES","10","0","0","0","10"
"2022","CAÑAR","BIBLIAN","1","1","0","0","2"
"2022","CAÑAR","CANAR","1","1","1","0","3"
"2022","CAÑAR","DELEG","1","0","0","0","1"
"2022","CAÑAR","EL TAMBO","0","0","0","0","0"
"2022","CAÑAR","LA TRONCAL","63","0","3","0","66"
"2022","CAÑAR","SUSCAL","0","0","0","0","0"
"2022","CARCHI","BOLIVAR","1","0","0","0","1"
"2022","CARCHI","BOLIVAR","0","0","0","0","0"
"2022","CARCHI","ESPEJO","0","0","0","0","0"
"2022","CARCHI","MIRA","0","0","0","0","0"
"2022","CARCHI","MONTUFAR","1","3","1","0","5"
"2022","CARCHI","SAN PEDRO DE HUACA","0","0","0","0","0"
"2022","CARCHI","TULCAN","2","1","3","0","6"
"2022","CHIMBORAZO","ALAUSI","0","0","0","0","0"
"2022","CHIMBORAZO","CHAMBO","0","0","0","0","0"
"2022","CHIMBORAZO","CHUNCHI","0","0","0","0","0"
"2022","CHIMBORAZO","COLTA","0","0","0","0","0"
"2022","CHIMBORAZO","CUMANDA","4","0","0","0","4"
"2022","CHIMBORAZO","GUAMOTE","0","0","0","0","0"
"2022","CHIMBORAZO","GUANO","0","1","0","0","1"
"2022","CHIMBORAZO","PALLATANGA","0","0","0","0","0"
"2022","CHIMBORAZO","PENIPE","0","0","0","0","0"
"2022","CHIMBORAZO","RIOBAMBA","8","1","1","0","10"
"2022","COTOPAXI","LA MANA","6","0","0","0","6"
"2022","COTOPAXI","LATACUNGA","17","1","3","0","21"
"2022","COTOPAXI","PANGUA","1","0","0","0","1"
"2022","COTOPAXI","PUJILI","0","0","0","0","0"
"2022","COTOPAXI","SALCEDO","1","1","0","0","2"
"2022","COTOPAXI","SAQUISILI","0","0","0","0","0"
"2022","COTOPAXI","SIGCHOS","0","0","0","0","0"
"2022","EL ORO","ARENILLAS","19","0","0","0","19"
"2022","EL ORO","ATAHUALPA","0","0","0","0","0"
"2022","EL ORO","BALSAS","0","0","0","0","0"
"2022","EL ORO","CHILLA","0","0","0","0","0"
"2022","EL ORO","EL GUABO","22","0","1","4","27"
"2022","EL ORO","HUAQUILLAS","47","0","0","0","47"
"2022","EL ORO","LAS LAJAS","0","0","0","0","0"
"2022","EL ORO","MACHALA","121","1","4","4","130"
"2022","EL ORO","MARCABELI","0","0","0","0","0"
"2022","EL ORO","PASAJE","36","1","0","2","39"
"2022","EL ORO","PINAS","2","0","0","0","2"
"2022","EL ORO","PORTOVELO","4","0","1","0","5"
"2022","EL ORO","SANTA ROSA","22","1","1","0","24"
"2022","EL ORO","ZARUMA","0","0","0","0","0"
"2022","ESMERALDAS","ATACAMES","14","0","0","0","14"
"2022","ESMERALDAS","ELOY ALFARO","13","0","0","0","13"
"2022","ESMERALDAS","ESMERALDAS","373","2","6","0","381"
"2022","ESMERALDAS","MUISNE","2","0","0","0","2"
"2022","ESMERALDAS","QUININDE","42","0","1","0","43"
"2022","ESMERALDAS","RIOVERDE","16","0","0","0","16"
"2022","ESMERALDAS","SAN LORENZO","50","1","2","0","53"
"2022","GALAPAGOS","ISABELA","0","0","0","0","0"
"2022","GALAPAGOS","SAN CRISTOBAL","0","0","0","0","0"
"2022","GALAPAGOS","SANTA CRUZ","0","0","0","0","0"
"2022","GUAYAS","ALFREDO BAQUERIZO MORENO (JUJAN)","10","1","0","0","11"
"2022","GUAYAS","BALAO","8","0","1","0","9"
"2022","GUAYAS","BALZAR","59","1","0","1","61"
"2022","GUAYAS","COLIMES","9","1","0","0","10"
"2022","GUAYAS","CORONEL MARCELINO MARIDUENA","1","0","0","0","1"
"2022","GUAYAS","DAULE","38","0","1","7","46"
"2022","GUAYAS","DURAN","119","1","1","0","121"
"2022","GUAYAS","EL EMPALME","41","0","2","1","44"
"2022","GUAYAS","EL TRIUNFO","29","0","1","2","32"
"2022","GUAYAS","GENERAL ANTONIO ELIZALDE","2","0","0","0","2"
"2022","GUAYAS","GUAYAQUIL","1,400","7","19","0","1,426"
"2022","GUAYAS","ISIDRO AYORA","3","0","0","0","3"
"2022","GUAYAS","LOMAS DE SARGENTILLO","1","0","0","0","1"
"2022","GUAYAS","MILAGRO","97","1","1","2","101"
"2022","GUAYAS","NARANJAL","36","1","2","0","39"
"2022","GUAYAS","NARANJITO","11","1","0","0","12"
"2022","GUAYAS","NOBOL","5","0","0","2","7"
"2022","GUAYAS","PALESTINA","12","0","0","0","12"
"2022","GUAYAS","PEDRO CARBO","8","1","0","0","9"
"2022","GUAYAS","PLAYAS","10","0","0","0","10"
"2022","GUAYAS","SALITRE (URBINA JADO)","6","1","0","1","8"
"2022","GUAYAS","SAMBORONDON","19","0","0","0","19"
"2022","GUAYAS","SAN JACINTO DE YAGUACHI","41","1","1","0","43"
"2022","GUAYAS","SANTA LUCIA","1","0","0","0","1"
"2022","GUAYAS","SIMON BOLIVAR","5","0","0","0","5"
"2022","IMBABURA","ANTONIO ANTE","1","0","0","0","1"
"2022","IMBABURA","COTACACHI","2","1","3","0","6"
"2022","IMBABURA","IBARRA","3","3","1","1","8"
"2022","IMBABURA","OTAVALO","1","0","0","0","1"
"2022","IMBABURA","PIMAMPIRO","0","0","0","0","0"
"2022","IMBABURA","SAN MIGUEL DE URCUQUI","0","0","0","0","0"
"2022","LOJA","CALVAS","1","0","0","0","1"
"2022","LOJA","CATAMAYO","4","0","0","0","4"
"2022","LOJA","CELICA","0","0","1","0","1"
"2022","LOJA","CHAGUARPAMBA","0","0","0","0","0"
"2022","LOJA","ESPINDOLA","0","0","0","0","0"
"2022","LOJA","GONZANAMA","0","0","0","0","0"
"2022","LOJA","LOJA","10","1","6","0","17"
"2022","LOJA","MACARA","1","0","0","0","1"
"2022","LOJA","PALTAS","0","0","0","0","0"
"2022","LOJA","PINDAL","0","0","0","0","0"
"2022","LOJA","PUYANGO","0","0","0","0","0"
"2022","LOJA","QUILANGA","0","0","0","0","0"
"2022","LOJA","SARAGURO","0","0","0","0","0"
"2022","LOJA","SOZORANGA","0","0","0","0","0"
"2022","LOJA","ZAPOTILLO","2","0","0","0","2"
"2022","LOS RÍOS","BABA","9","0","2","0","11"
"2022","LOS RÍOS","BABAHOYO","42","2","8","0","52"
"2022","LOS RÍOS","BUENA FE","29","0","4","0","33"
"2022","LOS RÍOS","MOCACHE","11","0","0","0","11"
"2022","LOS RÍOS","MONTALVO","2","0","0","0","2"
"2022","LOS RÍOS","PALENQUE","3","0","0","0","3"
"2022","LOS RÍOS","PUEBLOVIEJO","33","0","0","0","33"
"2022","LOS RÍOS","QUEVEDO","164","2","10","0","176"
"2022","LOS RÍOS","QUINSALOMA","10","1","3","1","15"
"2022","LOS RÍOS","URDANETA","8","0","0","1","9"
"2022","LOS RÍOS","VALENCIA","8","0","0","0","8"
"2022","LOS RÍOS","VENTANAS","31","0","4","2","37"
"2022","LOS RÍOS","VINCES","19","1","2","4","26"
"2022","MANABÍ","24 DE MAYO","1","2","0","0","3"
"2022","MANABÍ","BOLIVAR","37","0","0","0","37"
"2022","MANABÍ","CHONE","73","0","0","0","73"
"2022","MANABÍ","EL CARMEN","25","0","4","0","29"
"2022","MANABÍ","FLAVIO ALFARO","3","1","1","0","5"
"2022","MANABÍ","JAMA","2","0","1","0","3"
"2022","MANABÍ","JARAMIJO","5","0","0","1","6"
"2022","MANABÍ","JIPIJAPA","8","0","0","0","8"
"2022","MANABÍ","JUNIN","9","0","0","0","9"
"2022","MANABÍ","MANTA","81","1","3","5","90"
"2022","MANABÍ","MONTECRISTI","22","0","2","1","25"
"2022","MANABÍ","OLMEDO","0","0","0","0","0"
"2022","MANABÍ","PAJAN","8","1","0","0","9"
"2022","MANABÍ","PEDERNALES","66","1","3","0","70"
"2022","MANABÍ","PICHINCHA","3","0","0","0","3"
"2022","MANABÍ","PORTOVIEJO","92","2","2","0","96"
"2022","MANABÍ","PUERTO LOPEZ","10","0","1","0","11"
"2022","MANABÍ","ROCAFUERTE","1","0","0","0","1"
"2022","MANABÍ","SAN VICENTE","8","0","1","0","9"
"2022","MANABÍ","SANTA ANA","6","0","1","0","7"
"2022","MANABÍ","SUCRE","17","1","0","1","19"
"2022","MANABÍ","TOSAGUA","8","1","0","0","9"
"2022","MORONA SANTIAGO","GUALAQUIZA","0","1","0","0","1"
"2022","MORONA SANTIAGO","HUAMBOYA","0","0","0","0","0"
"2022","MORONA SANTIAGO","LIMON INDANZA","2","0","0","0","2"
"2022","MORONA SANTIAGO","LOGRONO","0","0","0","0","0"
"2022","MORONA SANTIAGO","MORONA","3","0","1","0","4"
"2022","MORONA SANTIAGO","PABLO SEXTO","0","0","0","0","0"
"2022","MORONA SANTIAGO","PALORA","0","0","1","0","1"
"2022","MORONA SANTIAGO","SAN JUAN BOSCO","0","0","0","0","0"
"2022","MORONA SANTIAGO","SANTIAGO","0","0","0","0","0"
"2022","MORONA SANTIAGO","SUCUA","0","0","1","0","1"
"2022","MORONA SANTIAGO","TAISHA","0","0","0","0","0"
"2022","MORONA SANTIAGO","TIWINTZA","0","0","0","0","0"
"2022","NAPO","ARCHIDONA","1","1","2","0","4"
"2022","NAPO","CARLOS JULIO AROSEMENA TOLA","0","0","1","0","1"
"2022","NAPO","EL CHACO","0","0","0","0","0"
"2022","NAPO","QUIJOS","0","0","0","0","0"
"2022","NAPO","TENA","11","1","1","0","13"
"2022","ORELLANA","AGUARICO","0","0","0","0","0"
"2022","ORELLANA","LA JOYA DE LOS SACHAS","5","0","1","0","6"
"2022","ORELLANA","LORETO","0","0","0","0","0"
"2022","ORELLANA","ORELLANA","9","2","6","0","17"
"2022","PASTAZA","ARAJUNO","0","0","1","0","1"
"2022","PASTAZA","MERA","1","0","0","0","1"
"2022","PASTAZA","PASTAZA","5","0","1","0","6"
"2022","PASTAZA","SANTA CLARA","0","0","0","0","0"
"2022","PICHINCHA","CAYAMBE","0","1","3","0","4"
"2022","PICHINCHA","MEJIA","1","0","2","0","3"
"2022","PICHINCHA","PEDRO MONCAYO","3","1","0","0","4"
"2022","PICHINCHA","PEDRO VICENTE MALDONADO","0","0","0","0","0"
"2022","PICHINCHA","PUERTO QUITO","5","0","1","0","6"
"2022","PICHINCHA","QUITO","58","4","138","0","200"
"2022","PICHINCHA","RUMINAHUI","1","0","2","0","3"
"2022","PICHINCHA","SAN MIGUEL DE LOS BANCOS","0","0","0","0","0"
"2022","SANTA ELENA","LA LIBERTAD","60","0","0","0","60"
"2022","SANTA ELENA","SALINAS","34","0","0","0","34"
"2022","SANTA ELENA","SANTA ELENA","20","3","0","0","23"
"2022","SANTO DOMINGO DE LOS TSÁCHILAS","LA CONCORDIA","12","0","3","0","15"
"2022","SANTO DOMINGO DE LOS TSÁCHILAS","SANTO DOMINGO","172","2","17","2","193"
"2022","SUCUMBÍOS","CASCALES","3","0","0","0","3"
"2022","SUCUMBÍOS","CUYABENO","1","0","0","0","1"
"2022","SUCUMBÍOS","GONZALO PIZARRO","0","0","1","0","1"
"2022","SUCUMBÍOS","LAGO AGRIO","58","0","2","0","60"
"2022","SUCUMBÍOS","PUTUMAYO","5","1","1","0","7"
"2022","SUCUMBÍOS","SHUSHUFINDI","8","0","2","0","10"
"2022","SUCUMBÍOS","SUCUMBIOS","0","0","0","0","0"
"2022","TUNGURAHUA","AMBATO","28","3","5","0","36"
"2022","TUNGURAHUA","BANOS DE AGUA SANTA","3","0","0","0","3"
"2022","TUNGURAHUA","CEVALLOS","0","0","0","0","0"
"2022","TUNGURAHUA","MOCHA","0","0","0","0","0"
"2022","TUNGURAHUA","PATATE","0","0","0","0","0"
"2022","TUNGURAHUA","QUERO","0","0","1","0","1"
"2022","TUNGURAHUA","SAN PEDRO DE PELILEO","0","0","1","0","1"
"2022","TUNGURAHUA","SANTIAGO DE PILLARO","1","0","0","0","1"
"2022","TUNGURAHUA","TISALEO","1","0","0","0","1"
"2022","ZAMORA CHINCHIPE","CENTINELA DEL CONDOR","0","0","0","0","0"
"2022","ZAMORA CHINCHIPE","CHINCHIPE","0","0","0","0","0"
"2022","ZAMORA CHINCHIPE","EL PANGUI","0","0","0","0","0"
"2022","ZAMORA CHINCHIPE","NANGARITZA","0","0","0","0","0"
"2022","ZAMORA CHINCHIPE","PALANDA","0","0","0","0","0"
"2022","ZAMORA CHINCHIPE","PAQUISHA","0","0","0","0","0"
"2022","ZAMORA CHINCHIPE","TACUAMBI","0","0","0","0","0"
"2022","ZAMORA CHINCHIPE","YANTZAZA (YANZATZA)","2","0","0","0","2"
"2022","ZAMORA CHINCHIPE","ZAMORA","0","0","1","0","1"
"2022","ZONAS NO DELIMITADAS","EL PIEDRERO","34","0","2","0","36"
"2022","ZONAS NO DELIMITADAS","LAS GOLONDRINAS","0","0","0","0","0"
"2022","ZONAS NO DELIMITADAS","MANGA DEL CURA","3","0","1","0","4"
"2022",".TOTAL","","4,363","83","332","46","4,824"
"2021","AZUAY","CAMILO PONCE ENRIQUEZ","4","1","2","0","7"
"2021","AZUAY","CHORDELEG","0","0","0","0","0"
"2021","AZUAY","CUENCA","36","3","9","0","48"
"2021","AZUAY","EL PAN","0","0","0","0","0"
"2021","AZUAY","GIRON","0","0","0","0","0"
"2021","AZUAY","GUACHAPALA","0","0","0","0","0"
"2021","AZUAY","GUALACEO","1","0","0","0","1"
"2021","AZUAY","NABON","0","0","1","0","1"
"2021","AZUAY","OÑA","0","0","0","0","0"
"2021","AZUAY","PAUTE","1","0","0","0","1"
"2021","AZUAY","PUCARA","0","0","0","0","0"
"2021","AZUAY","SAN FERNANDO","0","0","0","0","0"
"2021","AZUAY","SANTA ISABEL","1","0","0","0","1"
"2021","AZUAY","SEVILLA DE ORO","0","0","0","0","0"
"2021","AZUAY","SIGSIG","0","0","0","0","0"
"2021","BOLÍVAR","CALUMA","0","0","0","0","0"
"2021","BOLÍVAR","CHILLANES","1","0","2","0","3"
"2021","BOLÍVAR","CHIMBO","0","0","0","0","0"
"2021","BOLÍVAR","ECHEANDIA","0","0","0","0","0"
"2021","BOLÍVAR","GUARANDA","3","0","1","0","4"
"2021","BOLÍVAR","LAS NAVES","0","0","0","0","0"
"2021","BOLÍVAR","SAN MIGUEL DE BOLIVAR","0","0","0","0","0"
"2021","CAÑAR","AZOGUES","5","0","0","0","5"
"2021","CAÑAR","BIBLIAN","0","0","0","0","0"
"2021","CAÑAR","CANAR","3","0","0","0","3"
"2021","CAÑAR","DELEG","0","0","0","0","0"
"2021","CAÑAR","EL TAMBO","0","0","0","0","0"
"2021","CAÑAR","LA TRONCAL","32","0","1","0","33"
"2021","CAÑAR","SUSCAL","0","0","0","0","0"
"2021","CARCHI","BOLIVAR","0","0","0","0","0"
"2021","CARCHI","ESPEJO","0","0","0","0","0"
"2021","CARCHI","MIRA","1","1","0","0","2"
"2021","CARCHI","MONTUFAR","0","0","0","0","0"
"2021","CARCHI","SAN PEDRO DE HUACA","0","0","0","0","0"
"2021","CARCHI","TULCAN","4","0","0","0","4"
"2021","CHIMBORAZO","ALAUSI","0","0","0","0","0"
"2021","CHIMBORAZO","CHAMBO","0","0","1","0","1"
"2021","CHIMBORAZO","CHUNCHI","0","0","1","0","1"
"2021","CHIMBORAZO","COLTA","0","0","0","0","0"
"2021","CHIMBORAZO","CUMANDA","2","0","0","0","2"
"2021","CHIMBORAZO","GUAMOTE","0","0","0","0","0"
"2021","CHIMBORAZO","GUANO","2","0","1","0","3"
"2021","CHIMBORAZO","PALLATANGA","0","0","0","0","0"
"2021","CHIMBORAZO","PENIPE","0","0","0","0","0"
"2021","CHIMBORAZO","RIOBAMBA","5","1","1","1","8"
"2021","COTOPAXI","LA MANA","1","1","1","0","3"
"2021","COTOPAXI","LATACUNGA","30","2","5","1","38"
"2021","COTOPAXI","PANGUA","0","0","0","0","0"
"2021","COTOPAXI","PUJILI","2","0","0","0","2"
"2021","COTOPAXI","SALCEDO","1","0","0","0","1"
"2021","COTOPAXI","SAQUISILI","0","2","0","0","2"
"2021","COTOPAXI","SIGCHOS","1","0","0","0","1"
"2021","EL ORO","ARENILLAS","5","0","0","0","5"
"2021","EL ORO","ATAHUALPA","0","0","0","0","0"
"2021","EL ORO","BALSAS","2","0","0","0","2"
"2021","EL ORO","CHILLA","0","0","0","0","0"
"2021","EL ORO","EL GUABO","16","1","0","0","17"
"2021","EL ORO","HUAQUILLAS","19","0","3","0","22"
"2021","EL ORO","LAS LAJAS","1","0","0","0","1"
"2021","EL ORO","MACHALA","62","1","3","0","66"
"2021","EL ORO","MARCABELI","0","0","0","0","0"
"2021","EL ORO","PASAJE","19","1","2","0","22"
"2021","EL ORO","PINAS","2","0","0","0","2"
"2021","EL ORO","PORTOVELO","1","0","1","0","2"
"2021","EL ORO","SANTA ROSA","2","0","2","0","4"
"2021","EL ORO","ZARUMA","3","0","0","0","3"
"2021","ESMERALDAS","ATACAMES","16","1","1","0","18"
"2021","ESMERALDAS","ELOY ALFARO","4","0","0","0","4"
"2021","ESMERALDAS","ESMERALDAS","75","2","6","1","84"
"2021","ESMERALDAS","MUISNE","2","0","2","0","4"
"2021","ESMERALDAS","QUININDE","16","1","0","0","17"
"2021","ESMERALDAS","RIOVERDE","3","0","1","0","4"
"2021","ESMERALDAS","SAN LORENZO","19","0","1","0","20"
"2021","GALAPAGOS","ISABELA","0","0","0","0","0"
"2021","GALAPAGOS","SAN CRISTOBAL","0","0","0","0","0"
"2021","GALAPAGOS","SANTA CRUZ","0","0","0","0","0"
"2021","GUAYAS","ALFREDO BAQUERIZO MORENO (JUJAN)","2","2","0","0","4"
"2021","GUAYAS","BALAO","6","0","2","0","8"
"2021","GUAYAS","BALZAR","13","0","0","0","13"
"2021","GUAYAS","COLIMES","2","0","0","0","2"
"2021","GUAYAS","CORONEL MARCELINO MARIDUENA","2","1","0","0","3"
"2021","GUAYAS","DAULE","26","1","1","1","29"
"2021","GUAYAS","DURAN","71","0","1","3","75"
"2021","GUAYAS","EL EMPALME","27","0","0","0","27"
"2021","GUAYAS","EL TRIUNFO","18","1","1","0","20"
"2021","GUAYAS","GENERAL ANTONIO ELIZALDE","0","0","0","0","0"
"2021","GUAYAS","GUAYAQUIL","830","5","30","0","865"
"2021","GUAYAS","ISIDRO AYORA","1","0","1","0","2"
"2021","GUAYAS","LOMAS DE SARGENTILLO","2","0","0","0","2"
"2021","GUAYAS","MILAGRO","47","0","2","0","49"
"2021","GUAYAS","NARANJAL","37","0","3","0","40"
"2021","GUAYAS","NARANJITO","5","0","0","0","5"
"2021","GUAYAS","NOBOL","1","1","0","0","2"
"2021","GUAYAS","PALESTINA","4","0","0","0","4"
"2021","GUAYAS","PEDRO CARBO","5","1","0","0","6"
"2021","GUAYAS","PLAYAS","2","0","0","0","2"
"2021","GUAYAS","SALITRE (URBINA JADO)","2","1","0","0","3"
"2021","GUAYAS","SAMBORONDON","8","2","0","0","10"
"2021","GUAYAS","SAN JACINTO DE YAGUACHI","14","0","1","0","15"
"2021","GUAYAS","SANTA LUCIA","5","0","0","0","5"
"2021","GUAYAS","SIMON BOLIVAR","2","0","0","0","2"
"2021","IMBABURA","ANTONIO ANTE","1","0","1","0","2"
"2021","IMBABURA","COTACACHI","0","0","1","0","1"
"2021","IMBABURA","IBARRA","6","2","3","0","11"
"2021","IMBABURA","OTAVALO","1","0","3","0","4"
"2021","IMBABURA","PIMAMPIRO","0","0","0","0","0"
"2021","IMBABURA","SAN MIGUEL DE URCUQUI","1","0","0","0","1"
"2021","LOJA","CALVAS","0","0","0","0","0"
"2021","LOJA","CATAMAYO","1","0","0","0","1"
"2021","LOJA","CELICA","0","0","0","0","0"
"2021","LOJA","CHAGUARPAMBA","0","0","1","0","1"
"2021","LOJA","ESPINDOLA","0","0","0","0","0"
"2021","LOJA","GONZANAMA","1","0","0","0","1"
"2021","LOJA","LOJA","2","1","1","0","4"
"2021","LOJA","MACARA","0","0","0","0","0"
"2021","LOJA","OLMEDO","1","0","0","0","1"
"2021","LOJA","PALTAS","0","0","1","0","1"
"2021","LOJA","PINDAL","0","0","0","0","0"
"2021","LOJA","PUYANGO","0","0","0","0","0"
"2021","LOJA","QUILANGA","0","0","0","0","0"
"2021","LOJA","SARAGURO","0","1","0","0","1"
"2021","LOJA","SOZORANGA","0","0","0","0","0"
"2021","LOJA","ZAPOTILLO","0","0","0","0","0"
"2021","LOS RÍOS","BABA","2","0","3","0","5"
"2021","LOS RÍOS","BABAHOYO","48","0","3","0","51"
"2021","LOS RÍOS","BUENA FE","5","1","1","0","7"
"2021","LOS RÍOS","MOCACHE","7","1","0","0","8"
"2021","LOS RÍOS","MONTALVO","0","0","2","0","2"
"2021","LOS RÍOS","PALENQUE","0","0","0","0","0"
"2021","LOS RÍOS","PUEBLOVIEJO","18","0","0","1","19"
"2021","LOS RÍOS","QUEVEDO","70","0","1","3","74"
"2021","LOS RÍOS","QUINSALOMA","3","0","0","0","3"
"2021","LOS RÍOS","URDANETA","6","0","1","0","7"
"2021","LOS RÍOS","VALENCIA","0","0","0","0","0"
"2021","LOS RÍOS","VENTANAS","12","0","2","1","15"
"2021","LOS RÍOS","VINCES","5","0","1","0","6"
"2021","MANABÍ","24 DE MAYO","3","0","0","0","3"
"2021","MANABÍ","BOLIVAR","10","1","0","0","11"
"2021","MANABÍ","CHONE","19","2","0","2","23"
"2021","MANABÍ","EL CARMEN","15","0","1","0","16"
"2021","MANABÍ","FLAVIO ALFARO","2","0","0","1","3"
"2021","MANABÍ","JAMA","1","0","0","0","1"
"2021","MANABÍ","JARAMIJO","4","0","0","0","4"
"2021","MANABÍ","JIPIJAPA","2","0","0","0","2"
"2021","MANABÍ","JUNIN","0","0","0","0","0"
"2021","MANABÍ","MANTA","41","0","2","0","43"
"2021","MANABÍ","MONTECRISTI","6","0","0","0","6"
"2021","MANABÍ","OLMEDO","0","0","0","0","0"
"2021","MANABÍ","PAJAN","1","0","1","0","2"
"2021","MANABÍ","PEDERNALES","19","0","2","0","21"
"2021","MANABÍ","PICHINCHA","1","1","0","0","2"
"2021","MANABÍ","PORTOVIEJO","23","0","1","3","27"
"2021","MANABÍ","PUERTO LOPEZ","2","1","1","0","4"
"2021","MANABÍ","ROCAFUERTE","0","0","1","0","1"
"2021","MANABÍ","SAN VICENTE","1","0","0","0","1"
"2021","MANABÍ","SANTA ANA","10","0","0","0","10"
"2021","MANABÍ","SUCRE","14","0","0","0","14"
"2021","MANABÍ","TOSAGUA","1","0","0","0","1"
"2021","MORONA SANTIAGO","GUALAQUIZA","0","0","0","0","0"
"2021","MORONA SANTIAGO","HUAMBOYA","0","0","0","0","0"
"2021","MORONA SANTIAGO","LIMON INDANZA","0","0","0","0","0"
"2021","MORONA SANTIAGO","LOGRONO","0","0","0","0","0"
"2021","MORONA SANTIAGO","MORONA","2","0","1","1","4"
"2021","MORONA SANTIAGO","PABLO SEXTO","0","0","0","0","0"
"2021","MORONA SANTIAGO","PALORA","1","0","0","0","1"
"2021","MORONA SANTIAGO","SAN JUAN BOSCO","0","0","0","0","0"
"2021","MORONA SANTIAGO","SANTIAGO","0","0","0","0","0"
"2021","MORONA SANTIAGO","SUCUA","0","0","0","0","0"
"2021","MORONA SANTIAGO","TAISHA","0","0","1","0","1"
"2021","MORONA SANTIAGO","TIWINTZA","0","0","0","0","0"
"2021","NAPO","ARCHIDONA","1","0","0","0","1"
"2021","NAPO","CARLOS JULIO AROSEMENA TOLA","1","0","0","0","1"
"2021","NAPO","EL CHACO","0","0","0","0","0"
"2021","NAPO","QUIJOS","0","0","1","0","1"
"2021","NAPO","TENA","1","0","1","0","2"
"2021","ORELLANA","AGUARICO","0","0","0","0","0"
"2021","ORELLANA","LA JOYA DE LOS SACHAS","1","0","0","0","1"
"2021","ORELLANA","LORETO","1","1","0","0","2"
"2021","ORELLANA","ORELLANA","8","0","0","0","8"
"2021","PASTAZA","ARAJUNO","0","0","0","0","0"
"2021","PASTAZA","MERA","0","0","0","0","0"
"2021","PASTAZA","PASTAZA","6","1","0","0","7"
"2021","PASTAZA","SANTA CLARA","1","0","0","0","1"
"2021","PICHINCHA","CAYAMBE","2","1","1","0","4"
"2021","PICHINCHA","MEJIA","4","1","1","0","6"
"2021","PICHINCHA","PEDRO MONCAYO","0","1","1","0","2"
"2021","PICHINCHA","PEDRO VICENTE MALDONADO","0","0","0","0","0"
"2021","PICHINCHA","PUERTO QUITO","3","0","1","0","4"
"2021","PICHINCHA","QUITO","35","5","102","0","142"
"2021","PICHINCHA","RUMINAHUI","1","0","0","0","1"
"2021","PICHINCHA","SAN MIGUEL DE LOS BANCOS","1","0","0","0","1"
"2021","SANTA ELENA","LA LIBERTAD","18","1","2","0","21"
"2021","SANTA ELENA","SALINAS","6","0","0","0","6"
"2021","SANTA ELENA","SANTA ELENA","18","1","0","0","19"
"2021","SANTO DOMINGO DE LOS TSÁCHILAS","LA CONCORDIA","3","1","1","0","5"
"2021","SANTO DOMINGO DE LOS TSÁCHILAS","SANTO DOMINGO","50","2","13","1","66"
"2021","SUCUMBÍOS","CASCALES","0","1","1","0","2"
"2021","SUCUMBÍOS","CUYABENO","0","0","0","0","0"
"2021","SUCUMBÍOS","GONZALO PIZARRO","0","1","0","0","1"
"2021","SUCUMBÍOS","LAGO AGRIO","23","1","4","0","28"
"2021","SUCUMBÍOS","PUTUMAYO","1","0","1","0","2"
"2021","SUCUMBÍOS","SHUSHUFINDI","3","3","0","0","6"
"2021","SUCUMBÍOS","SUCUMBIOS","0","0","0","0","0"
"2021","TUNGURAHUA","AMBATO","13","1","2","0","16"
"2021","TUNGURAHUA","BANOS DE AGUA SANTA","1","0","0","0","1"
"2021","TUNGURAHUA","CEVALLOS","0","0","0","0","0"
"2021","TUNGURAHUA","MOCHA","0","1","0","0","1"
"2021","TUNGURAHUA","PATATE","0","0","0","0","0"
"2021","TUNGURAHUA","QUERO","0","0","0","0","0"
"2021","TUNGURAHUA","SAN PEDRO DE PELILEO","1","1","0","0","2"
"2021","TUNGURAHUA","SANTIAGO DE PILLARO","1","0","0","0","1"
"2021","TUNGURAHUA","TISALEO","0","0","0","0","0"
"2021","ZAMORA CHINCHIPE","CENTINELA DEL CONDOR","0","0","0","0","0"
"2021","ZAMORA CHINCHIPE","CHINCHIPE","0","0","0","0","0"
"2021","ZAMORA CHINCHIPE","EL PANGUI","0","1","0","0","1"
"2021","ZAMORA CHINCHIPE","NANGARITZA","3","0","0","0","3"
"2021","ZAMORA CHINCHIPE","PALANDA","0","0","0","0","0"
"2021","ZAMORA CHINCHIPE","PAQUISHA","0","0","0","0","0"
"2021","ZAMORA CHINCHIPE","TACUAMBI","0","0","0","0","0"
"2021","ZAMORA CHINCHIPE","YANTZAZA (YANZATZA)","0","0","0","0","0"
"2021","ZAMORA CHINCHIPE","ZAMORA","0","1","1","0","2"
"2021","ZONAS NO DELIMITADAS","EL PIEDRERO","28","0","0","0","28"
"2021","ZONAS NO DELIMITADAS","LAS GOLONDRINAS","3","0","0","0","3"
"2021","ZONAS NO DELIMITADAS","MANGA DEL CURA","5","0","0","0","5"
"2021",".TOTAL","","2,146","70","259","20","2,495"
"2020","AZUAY","CAMILO PONCE ENRIQUEZ","2","0","3","0","5"
"2020","AZUAY","CHORDELEG","0","0","0","0","0"
"2020","AZUAY","CUENCA","13","3","7","0","23"
"2020","AZUAY","EL PAN","0","0","1","0","1"
"2020","AZUAY","GIRON","0","0","1","0","1"
"2020","AZUAY","GUACHAPALA","0","0","0","0","0"
"2020","AZUAY","GUALACEO","0","0","0","0","0"
"2020","AZUAY","NABON","0","0","0","0","0"
"2020","AZUAY","OÑA","0","0","0","0","0"
"2020","AZUAY","PAUTE","0","0","0","0","0"
"2020","AZUAY","PUCARA","0","0","0","0","0"
"2020","AZUAY","SAN FERNANDO","0","0","0","0","0"
"2020","AZUAY","SANTA ISABEL","0","1","1","0","2"
"2020","AZUAY","SEVILLA DE ORO","0","0","1","0","1"
"2020","AZUAY","SIGSIG","0","0","0","0","0"
"2020","BOLÍVAR","CALUMA","1","1","0","0","2"
"2020","BOLÍVAR","CHILLANES","1","0","1","0","2"
"2020","BOLÍVAR","CHIMBO","0","0","0","0","0"
"2020","BOLÍVAR","ECHEANDIA","0","0","0","0","0"
"2020","BOLÍVAR","GUARANDA","4","1","0","0","5"
"2020","BOLÍVAR","LAS NAVES","0","0","0","0","0"
"2020","BOLÍVAR","SAN MIGUEL DE BOLIVAR","0","1","2","0","3"
"2020","CAÑAR","AZOGUES","0","0","0","0","0"
"2020","CAÑAR","BIBLIAN","0","0","1","0","1"
"2020","CAÑAR","CANAR","1","0","0","0","1"
"2020","CAÑAR","DELEG","0","0","0","0","0"
"2020","CAÑAR","EL TAMBO","0","0","1","0","1"
"2020","CAÑAR","LA TRONCAL","10","2","1","1","14"
"2020","CAÑAR","SUSCAL","0","0","0","0","0"
"2020","CARCHI","BOLIVAR","0","0","0","0","0"
"2020","CARCHI","ESPEJO","0","0","0","0","0"
"2020","CARCHI","MIRA","1","0","1","0","2"
"2020","CARCHI","MONTUFAR","1","0","0","0","1"
"2020","CARCHI","SAN PEDRO DE HUACA","0","0","0","0","0"
"2020","CARCHI","TULCAN","1","1","2","0","4"
"2020","CHIMBORAZO","ALAUSI","2","0","0","0","2"
"2020","CHIMBORAZO","CHAMBO","0","0","0","0","0"
"2020","CHIMBORAZO","CHUNCHI","0","0","0","0","0"
"2020","CHIMBORAZO","COLTA","1","0","0","0","1"
"2020","CHIMBORAZO","CUMANDA","1","0","0","0","1"
"2020","CHIMBORAZO","GUAMOTE","0","0","0","0","0"
"2020","CHIMBORAZO","GUANO","0","0","1","0","1"
"2020","CHIMBORAZO","PALLATANGA","0","0","0","0","0"
"2020","CHIMBORAZO","PENIPE","0","0","0","0","0"
"2020","CHIMBORAZO","RIOBAMBA","6","1","1","0","8"
"2020","COTOPAXI","LA MANA","2","0","1","0","3"
"2020","COTOPAXI","LATACUNGA","15","1","1","0","17"
"2020","COTOPAXI","PANGUA","0","0","0","0","0"
"2020","COTOPAXI","PUJILI","1","0","2","0","3"
"2020","COTOPAXI","SALCEDO","2","1","1","0","4"
"2020","COTOPAXI","SAQUISILI","0","1","0","0","1"
"2020","COTOPAXI","SIGCHOS","0","0","0","0","0"
"2020","EL ORO","ARENILLAS","2","0","3","1","6"
"2020","EL ORO","ATAHUALPA","0","0","0","0","0"
"2020","EL ORO","BALSAS","0","0","0","0","0"
"2020","EL ORO","CHILLA","0","0","0","0","0"
"2020","EL ORO","EL GUABO","4","0","2","1","7"
"2020","EL ORO","HUAQUILLAS","15","0","1","0","16"
"2020","EL ORO","LAS LAJAS","0","0","0","0","0"
"2020","EL ORO","MACHALA","36","0","6","0","42"
"2020","EL ORO","MARCABELI","0","0","0","0","0"
"2020","EL ORO","PASAJE","6","2","1","0","9"
"2020","EL ORO","PINAS","0","0","1","0","1"
"2020","EL ORO","PORTOVELO","3","1","0","0","4"
"2020","EL ORO","SANTA ROSA","8","0","2","0","10"
"2020","EL ORO","ZARUMA","0","0","0","0","0"
"2020","ESMERALDAS","ATACAMES","7","0","0","0","7"
"2020","ESMERALDAS","ELOY ALFARO","7","0","0","0","7"
"2020","ESMERALDAS","ESMERALDAS","30","1","2","1","34"
"2020","ESMERALDAS","MUISNE","3","0","0","0","3"
"2020","ESMERALDAS","QUININDE","9","0","4","0","13"
"2020","ESMERALDAS","RIOVERDE","2","0","2","0","4"
"2020","ESMERALDAS","SAN LORENZO","10","0","2","0","12"
"2020","GALAPAGOS","ISABELA","0","0","0","0","0"
"2020","GALAPAGOS","SAN CRISTOBAL","0","0","0","0","0"
"2020","GALAPAGOS","SANTA CRUZ","0","1","0","0","1"
"2020","GUAYAS","ALFREDO BAQUERIZO MORENO (JUJAN)","1","0","0","0","1"
"2020","GUAYAS","BALAO","7","0","0","0","7"
"2020","GUAYAS","BALZAR","6","0","0","1","7"
"2020","GUAYAS","COLIMES","1","1","0","0","2"
"2020","GUAYAS","CORONEL MARCELINO MARIDUENA","1","0","0","0","1"
"2020","GUAYAS","DAULE","13","1","0","0","14"
"2020","GUAYAS","DURAN","47","0","2","0","49"
"2020","GUAYAS","EL EMPALME","18","2","0","0","20"
"2020","GUAYAS","EL TRIUNFO","7","1","0","0","8"
"2020","GUAYAS","GENERAL ANTONIO ELIZALDE","0","0","0","0","0"
"2020","GUAYAS","GUAYAQUIL","305","5","18","1","329"
"2020","GUAYAS","ISIDRO AYORA","1","0","0","0","1"
"2020","GUAYAS","LOMAS DE SARGENTILLO","3","0","0","0","3"
"2020","GUAYAS","MILAGRO","26","3","0","0","29"
"2020","GUAYAS","NARANJAL","23","0","2","0","25"
"2020","GUAYAS","NARANJITO","1","0","0","0","1"
"2020","GUAYAS","NOBOL","4","0","0","0","4"
"2020","GUAYAS","PALESTINA","4","0","0","0","4"
"2020","GUAYAS","PEDRO CARBO","2","0","0","0","2"
"2020","GUAYAS","PLAYAS","3","0","0","0","3"
"2020","GUAYAS","SALITRE (URBINA JADO)","0","0","0","0","0"
"2020","GUAYAS","SAMBORONDON","6","0","0","0","6"
"2020","GUAYAS","SAN JACINTO DE YAGUACHI","5","1","0","0","6"
"2020","GUAYAS","SANTA LUCIA","2","0","0","0","2"
"2020","GUAYAS","SIMON BOLIVAR","4","0","0","0","4"
"2020","IMBABURA","ANTONIO ANTE","2","0","1","0","3"
"2020","IMBABURA","COTACACHI","1","1","0","0","2"
"2020","IMBABURA","IBARRA","4","2","2","0","8"
"2020","IMBABURA","OTAVALO","5","2","1","0","8"
"2020","IMBABURA","PIMAMPIRO","1","0","0","0","1"
"2020","IMBABURA","SAN MIGUEL DE URCUQUI","0","0","0","0","0"
"2020","LOJA","CALVAS","0","0","0","0","0"
"2020","LOJA","CATAMAYO","0","0","0","0","0"
"2020","LOJA","CELICA","0","0","0","0","0"
"2020","LOJA","CHAGUARPAMBA","0","0","0","0","0"
"2020","LOJA","ESPINDOLA","0","0","0","0","0"
"2020","LOJA","GONZANAMA","0","0","0","0","0"
"2020","LOJA","LOJA","2","0","4","0","6"
"2020","LOJA","MACARA","1","0","0","0","1"
"2020","LOJA","OLMEDO","0","0","1","0","1"
"2020","LOJA","PALTAS","0","0","0","0","0"
"2020","LOJA","PINDAL","0","0","0","0","0"
"2020","LOJA","PUYANGO","1","0","0","0","1"
"2020","LOJA","QUILANGA","0","0","0","0","0"
"2020","LOJA","SARAGURO","0","0","0","0","0"
"2020","LOJA","SOZORANGA","0","0","0","0","0"
"2020","LOJA","ZAPOTILLO","1","0","0","0","1"
"2020","LOS RÍOS","BABA","3","0","0","0","3"
"2020","LOS RÍOS","BABAHOYO","18","1","2","0","21"
"2020","LOS RÍOS","BUENA FE","7","0","1","0","8"
"2020","LOS RÍOS","MOCACHE","1","0","0","0","1"
"2020","LOS RÍOS","MONTALVO","0","0","0","0","0"
"2020","LOS RÍOS","PALENQUE","3","0","0","0","3"
"2020","LOS RÍOS","PUEBLOVIEJO","12","0","1","0","13"
"2020","LOS RÍOS","QUEVEDO","31","2","4","1","38"
"2020","LOS RÍOS","QUINSALOMA","2","0","0","0","2"
"2020","LOS RÍOS","URDANETA","0","1","0","2","3"
"2020","LOS RÍOS","VALENCIA","1","0","0","0","1"
"2020","LOS RÍOS","VENTANAS","8","0","2","1","11"
"2020","LOS RÍOS","VINCES","2","3","1","0","6"
"2020","MANABÍ","24 DE MAYO","0","0","0","0","0"
"2020","MANABÍ","BOLIVAR","5","1","1","0","7"
"2020","MANABÍ","CHONE","16","0","1","0","17"
"2020","MANABÍ","EL CARMEN","8","0","0","0","8"
"2020","MANABÍ","FLAVIO ALFARO","2","0","0","0","2"
"2020","MANABÍ","JAMA","0","0","1","0","1"
"2020","MANABÍ","JARAMIJO","0","1","0","0","1"
"2020","MANABÍ","JIPIJAPA","4","0","0","0","4"
"2020","MANABÍ","JUNIN","0","0","0","0","0"
"2020","MANABÍ","MANTA","27","2","0","1","30"
"2020","MANABÍ","MONTECRISTI","6","2","1","0","9"
"2020","MANABÍ","OLMEDO","0","0","0","0","0"
"2020","MANABÍ","PAJAN","3","0","0","0","3"
"2020","MANABÍ","PEDERNALES","13","0","1","0","14"
"2020","MANABÍ","PICHINCHA","2","0","0","0","2"
"2020","MANABÍ","PORTOVIEJO","10","1","1","0","12"
"2020","MANABÍ","PUERTO LOPEZ","0","0","0","0","0"
"2020","MANABÍ","ROCAFUERTE","0","0","0","0","0"
"2020","MANABÍ","SAN VICENTE","4","0","0","0","4"
"2020","MANABÍ","SANTA ANA","3","0","0","0","3"
"2020","MANABÍ","SUCRE","1","0","0","0","1"
"2020","MANABÍ","TOSAGUA","0","1","0","0","1"
"2020","MORONA SANTIAGO","GUALAQUIZA","0","0","1","0","1"
"2020","MORONA SANTIAGO","HUAMBOYA","0","0","1","0","1"
"2020","MORONA SANTIAGO","LIMON INDANZA","0","0","0","0","0"
"2020","MORONA SANTIAGO","LOGRONO","0","0","0","0","0"
"2020","MORONA SANTIAGO","MORONA","2","1","1","0","4"
"2020","MORONA SANTIAGO","PABLO SEXTO","0","0","0","0","0"
"2020","MORONA SANTIAGO","PALORA","1","0","0","0","1"
"2020","MORONA SANTIAGO","SAN JUAN BOSCO","0","0","0","0","0"
"2020","MORONA SANTIAGO","SANTIAGO","0","0","0","0","0"
"2020","MORONA SANTIAGO","SUCUA","3","0","1","0","4"
"2020","MORONA SANTIAGO","TAISHA","0","0","0","0","0"
"2020","MORONA SANTIAGO","TIWINTZA","0","0","0","0","0"
"2020","NAPO","ARCHIDONA","1","0","0","0","1"
"2020","NAPO","CARLOS JULIO AROSEMENA TOLA","0","0","0","0","0"
"2020","NAPO","EL CHACO","0","0","0","0","0"
"2020","NAPO","QUIJOS","0","0","0","0","0"
"2020","NAPO","TENA","1","0","1","0","2"
"2020","ORELLANA","AGUARICO","0","0","0","0","0"
"2020","ORELLANA","LA JOYA DE LOS SACHAS","3","1","0","0","4"
"2020","ORELLANA","LORETO","0","0","0","0","0"
"2020","ORELLANA","ORELLANA","1","0","0","0","1"
"2020","PASTAZA","ARAJUNO","0","0","0","0","0"
"2020","PASTAZA","MERA","1","0","0","0","1"
"2020","PASTAZA","PASTAZA","1","0","0","0","1"
"2020","PASTAZA","SANTA CLARA","0","0","0","0","0"
"2020","PICHINCHA","CAYAMBE","0","0","3","0","3"
"2020","PICHINCHA","MEJIA","1","0","1","0","2"
"2020","PICHINCHA","PEDRO MONCAYO","3","1","0","0","4"
"2020","PICHINCHA","PEDRO VICENTE MALDONADO","0","0","0","0","0"
"2020","PICHINCHA","PUERTO QUITO","1","0","0","0","1"
"2020","PICHINCHA","QUITO","26","8","110","0","144"
"2020","PICHINCHA","RUMINAHUI","0","2","2","0","4"
"2020","PICHINCHA","SAN MIGUEL DE LOS BANCOS","0","1","0","0","1"
"2020","SANTA ELENA","LA LIBERTAD","4","0","0","0","4"
"2020","SANTA ELENA","SALINAS","5","0","1","3","6"
"2020","SANTA ELENA","SANTA ELENA","4","0","1","0","5"
"2020","SANTO DOMINGO DE LOS TSÁCHILAS","LA CONCORDIA","2","0","4","0","6"
"2020","SANTO DOMINGO DE LOS TSÁCHILAS","SANTO DOMINGO","12","2","16","4","30"
"2020","SUCUMBÍOS","CASCALES","0","0","1","0","1"
"2020","SUCUMBÍOS","CUYABENO","3","0","0","0","3"
"2020","SUCUMBÍOS","GONZALO PIZARRO","0","0","0","0","0"
"2020","SUCUMBÍOS","LAGO AGRIO","14","0","2","0","16"
"2020","SUCUMBÍOS","PUTUMAYO","2","0","1","0","3"
"2020","SUCUMBÍOS","SHUSHUFINDI","6","2","0","0","8"
"2020","SUCUMBÍOS","SUCUMBIOS","0","0","2","0","2"
"2020","TUNGURAHUA","AMBATO","7","2","6","0","15"
"2020","TUNGURAHUA","BANOS DE AGUA SANTA","0","0","0","0","0"
"2020","TUNGURAHUA","CEVALLOS","0","0","0","0","0"
"2020","TUNGURAHUA","MOCHA","0","0","0","0","0"
"2020","TUNGURAHUA","PATATE","0","0","0","0","0"
"2020","TUNGURAHUA","QUERO","0","0","0","0","0"
"2020","TUNGURAHUA","SAN PEDRO DE PELILEO","1","0","0","0","1"
"2020","TUNGURAHUA","SANTIAGO DE PILLARO","1","0","1","0","2"
"2020","TUNGURAHUA","TISALEO","0","0","0","0","0"
"2020","ZAMORA CHINCHIPE","CENTINELA DEL CONDOR","0","0","0","0","0"
"2020","ZAMORA CHINCHIPE","CHINCHIPE","0","0","0","0","0"
"2020","ZAMORA CHINCHIPE","EL PANGUI","0","0","0","0","0"
"2020","ZAMORA CHINCHIPE","NANGARITZA","0","0","0","0","0"
"2020","ZAMORA CHINCHIPE","PALANDA","0","0","0","0","0"
"2020","ZAMORA CHINCHIPE","PAQUISHA","0","0","0","0","0"
"2020","ZAMORA CHINCHIPE","TACUAMBI","0","0","0","0","0"
"2020","ZAMORA CHINCHIPE","YANTZAZA (YANZATZA)","0","0","0","0","0"
"2020","ZAMORA CHINCHIPE","ZAMORA","0","0","1","0","1"
"2020","ZONAS NO DELIMITADAS","EL PIEDRERO","9","0","1","0","10"
"2020","ZONAS NO DELIMITADAS","LAS GOLONDRINAS","0","0","0","0","0"
"2020","ZONAS NO DELIMITADAS","MANGA DEL CURA","4","0","0","0","4"
"2020",".TOTAL","","1,026","73","262","18","1,372"
"2019","AZUAY","CAMILO PONCE ENRIQUEZ","2","0","1","0","3"
"2019","AZUAY","CHORDELEG","0","0","0","0","0"
"2019","AZUAY","CUENCA","10","1","5","0","16"
"2019","AZUAY","EL PAN","0","0","0","0","0"
"2019","AZUAY","GIRON","0","0","0","0","0"
"2019","AZUAY","GUACHAPALA","0","0","0","0","0"
"2019","AZUAY","GUALACEO","0","0","1","0","1"
"2019","AZUAY","NABON","0","0","1","0","1"
"2019","AZUAY","OÑA","0","0","0","0","0"
"2019","AZUAY","PAUTE","0","0","0","0","0"
"2019","AZUAY","PUCARA","0","0","0","0","0"
"2019","AZUAY","SAN FERNANDO","1","0","0","0","1"
"2019","AZUAY","SANTA ISABEL","2","0","0","0","2"
"2019","AZUAY","SEVILLA DE ORO","0","0","0","0","0"
"2019","AZUAY","SIGSIG","0","0","0","0","0"
"2019","BOLÍVAR","CALUMA","1","0","0","0","1"
"2019","BOLÍVAR","CHILLANES","1","0","0","0","1"
"2019","BOLÍVAR","CHIMBO","2","0","0","0","2"
"2019","BOLÍVAR","ECHEANDIA","0","0","0","3","3"
"2019","BOLÍVAR","GUARANDA","0","0","1","0","1"
"2019","BOLÍVAR","LAS NAVES","0","0","0","0","0"
"2019","BOLÍVAR","SAN MIGUEL DE BOLIVAR","1","0","0","0","1"
"2019","CAÑAR","AZOGUES","0","0","0","0","0"
"2019","CAÑAR","BIBLIAN","0","0","0","0","0"
"2019","CAÑAR","CANAR","0","0","1","0","1"
"2019","CAÑAR","DELEG","0","0","0","0","0"
"2019","CAÑAR","EL TAMBO","2","0","0","0","2"
"2019","CAÑAR","LA TRONCAL","2","0","1","0","3"
"2019","CAÑAR","SUSCAL","0","0","0","0","0"
"2019","CARCHI","BOLIVAR","0","0","0","0","0"
"2019","CARCHI","ESPEJO","0","1","1","0","2"
"2019","CARCHI","MIRA","0","0","0","0","0"
"2019","CARCHI","MONTUFAR","0","0","0","0","0"
"2019","CARCHI","SAN PEDRO DE HUACA","0","0","0","0","0"
"2019","CARCHI","TULCAN","1","1","1","0","3"
"2019","CHIMBORAZO","ALAUSI","1","0","0","0","1"
"2019","CHIMBORAZO","CHAMBO","0","0","0","0","0"
"2019","CHIMBORAZO","CHUNCHI","0","0","0","0","0"
"2019","CHIMBORAZO","COLTA","0","0","2","0","2"
"2019","CHIMBORAZO","CUMANDA","0","0","0","0","0"
"2019","CHIMBORAZO","GUAMOTE","0","0","0","0","0"
"2019","CHIMBORAZO","GUANO","0","0","1","0","1"
"2019","CHIMBORAZO","PALLATANGA","0","0","0","0","0"
"2019","CHIMBORAZO","PENIPE","0","0","0","0","0"
"2019","CHIMBORAZO","RIOBAMBA","6","0","3","0","9"
"2019","COTOPAXI","LA MANA","1","1","0","0","2"
"2019","COTOPAXI","LATACUNGA","10","4","6","0","20"
"2019","COTOPAXI","PANGUA","0","0","1","0","1"
"2019","COTOPAXI","PUJILI","0","0","0","0","0"
"2019","COTOPAXI","SALCEDO","3","1","0","0","4"
"2019","COTOPAXI","SAQUISILI","0","0","0","0","0"
"2019","COTOPAXI","SIGCHOS","1","0","0","0","1"
"2019","EL ORO","ARENILLAS","3","0","2","0","5"
"2019","EL ORO","ATAHUALPA","0","0","0","0","0"
"2019","EL ORO","BALSAS","0","0","0","0","0"
"2019","EL ORO","CHILLA","2","0","0","0","2"
"2019","EL ORO","EL GUABO","11","0","1","1","13"
"2019","EL ORO","HUAQUILLAS","13","2","2","0","17"
"2019","EL ORO","LAS LAJAS","0","0","0","0","0"
"2019","EL ORO","MACHALA","21","2","8","0","31"
"2019","EL ORO","MARCABELI","0","0","0","0","0"
"2019","EL ORO","PASAJE","7","0","3","0","10"
"2019","EL ORO","PINAS","0","0","1","0","1"
"2019","EL ORO","PORTOVELO","1","0","0","0","1"
"2019","EL ORO","SANTA ROSA","1","1","3","0","5"
"2019","EL ORO","ZARUMA","2","0","0","0","2"
"2019","ESMERALDAS","ATACAMES","5","0","1","0","6"
"2019","ESMERALDAS","ELOY ALFARO","3","0","1","0","4"
"2019","ESMERALDAS","ESMERALDAS","22","0","2","0","24"
"2019","ESMERALDAS","MUISNE","3","0","0","0","3"
"2019","ESMERALDAS","QUININDE","7","0","4","0","11"
"2019","ESMERALDAS","RIOVERDE","0","0","1","0","1"
"2019","ESMERALDAS","SAN LORENZO","15","0","3","0","18"
"2019","GALAPAGOS","ISABELA","0","0","0","0","0"
"2019","GALAPAGOS","SAN CRISTOBAL","0","0","0","0","0"
"2019","GALAPAGOS","SANTA CRUZ","0","0","0","0","0"
"2019","GUAYAS","ALFREDO BAQUERIZO MORENO (JUJAN)","2","0","0","0","2"
"2019","GUAYAS","BALAO","2","0","1","0","3"
"2019","GUAYAS","BALZAR","4","0","0","0","4"
"2019","GUAYAS","COLIMES","2","0","0","0","2"
"2019","GUAYAS","CORONEL MARCELINO MARIDUENA","1","0","1","0","2"
"2019","GUAYAS","DAULE","7","2","0","1","10"
"2019","GUAYAS","DURAN","24","3","1","0","28"
"2019","GUAYAS","EL EMPALME","9","0","0","0","9"
"2019","GUAYAS","EL TRIUNFO","12","2","0","0","14"
"2019","GUAYAS","GENERAL ANTONIO ELIZALDE","0","0","0","0","0"
"2019","GUAYAS","GUAYAQUIL","248","5","16","0","269"
"2019","GUAYAS","ISIDRO AYORA","3","0","0","0","3"
"2019","GUAYAS","LOMAS DE SARGENTILLO","1","0","0","0","1"
"2019","GUAYAS","MILAGRO","21","3","1","0","25"
"2019","GUAYAS","NARANJAL","7","0","1","0","8"
"2019","GUAYAS","NARANJITO","4","0","0","0","4"
"2019","GUAYAS","NOBOL","1","0","0","0","1"
"2019","GUAYAS","PALESTINA","3","0","0","0","3"
"2019","GUAYAS","PEDRO CARBO","3","0","1","0","4"
"2019","GUAYAS","PLAYAS","1","0","0","0","1"
"2019","GUAYAS","SALITRE (URBINA JADO)","3","0","0","0","3"
"2019","GUAYAS","SAMBORONDON","1","0","0","0","1"
"2019","GUAYAS","SAN JACINTO DE YAGUACHI","6","0","0","0","6"
"2019","GUAYAS","SANTA LUCIA","3","0","0","0","3"
"2019","GUAYAS","SIMON BOLIVAR","1","1","1","0","3"
"2019","IMBABURA","ANTONIO ANTE","1","0","1","0","2"
"2019","IMBABURA","COTACACHI","1","0","0","0","1"
"2019","IMBABURA","IBARRA","8","1","2","0","11"
"2019","IMBABURA","OTAVALO","1","0","2","0","3"
"2019","IMBABURA","PIMAMPIRO","1","0","1","0","2"
"2019","IMBABURA","SAN MIGUEL DE URCUQUI","6","0","0","0","6"
"2019","LOJA","CALVAS","1","0","0","0","1"
"2019","LOJA","CATAMAYO","0","0","0","0","0"
"2019","LOJA","CELICA","0","0","0","0","0"
"2019","LOJA","CHAGUARPAMBA","0","0","0","0","0"
"2019","LOJA","ESPINDOLA","0","0","0","0","0"
"2019","LOJA","GONZANAMA","0","0","0","0","0"
"2019","LOJA","LOJA","3","0","1","0","4"
"2019","LOJA","MACARA","0","1","0","0","1"
"2019","LOJA","OLMEDO","1","0","0","0","1"
"2019","LOJA","PALTAS","0","0","0","0","0"
"2019","LOJA","PINDAL","0","0","0","0","0"
"2019","LOJA","PUYANGO","0","0","0","0","0"
"2019","LOJA","QUILANGA","0","0","0","0","0"
"2019","LOJA","SARAGURO","0","1","1","0","2"
"2019","LOJA","SOZORANGA","0","0","0","0","0"
"2019","LOJA","ZAPOTILLO","0","0","0","0","0"
"2019","LOS RÍOS","BABA","5","0","0","0","5"
"2019","LOS RÍOS","BABAHOYO","11","1","5","0","17"
"2019","LOS RÍOS","BUENA FE","9","0","2","0","11"
"2019","LOS RÍOS","MOCACHE","1","0","1","0","2"
"2019","LOS RÍOS","MONTALVO","1","0","0","0","1"
"2019","LOS RÍOS","PALENQUE","4","0","0","0","4"
"2019","LOS RÍOS","PUEBLOVIEJO","13","0","1","0","14"
"2019","LOS RÍOS","QUEVEDO","26","0","1","0","27"
"2019","LOS RÍOS","QUINSALOMA","0","1","1","0","2"
"2019","LOS RÍOS","URDANETA","3","0","1","0","4"
"2019","LOS RÍOS","VALENCIA","7","0","0","0","7"
"2019","LOS RÍOS","VENTANAS","9","0","0","0","9"
"2019","LOS RÍOS","VINCES","7","1","0","0","8"
"2019","MANABÍ","24 DE MAYO","3","0","1","0","4"
"2019","MANABÍ","BOLIVAR","5","0","0","0","5"
"2019","MANABÍ","CHONE","5","1","1","0","7"
"2019","MANABÍ","EL CARMEN","17","0","1","0","18"
"2019","MANABÍ","FLAVIO ALFARO","7","0","1","0","8"
"2019","MANABÍ","JAMA","1","0","0","0","1"
"2019","MANABÍ","JARAMIJO","4","0","0","0","4"
"2019","MANABÍ","JIPIJAPA","0","2","0","0","2"
"2019","MANABÍ","JUNIN","0","0","0","0","0"
"2019","MANABÍ","MANTA","12","0","1","0","13"
"2019","MANABÍ","MONTECRISTI","7","0","0","0","7"
"2019","MANABÍ","OLMEDO","0","0","0","0","0"
"2019","MANABÍ","PAJAN","1","0","1","0","2"
"2019","MANABÍ","PEDERNALES","2","1","1","0","4"
"2019","MANABÍ","PICHINCHA","3","0","0","0","3"
"2019","MANABÍ","PORTOVIEJO","19","1","3","0","23"
"2019","MANABÍ","PUERTO LOPEZ","0","0","0","0","0"
"2019","MANABÍ","ROCAFUERTE","1","0","0","0","1"
"2019","MANABÍ","SAN VICENTE","3","0","0","0","3"
"2019","MANABÍ","SANTA ANA","2","0","0","0","2"
"2019","MANABÍ","SUCRE","3","0","0","0","3"
"2019","MANABÍ","TOSAGUA","3","0","0","0","3"
"2019","MORONA SANTIAGO","GUALAQUIZA","1","0","0","0","1"
"2019","MORONA SANTIAGO","HUAMBOYA","0","0","0","0","0"
"2019","MORONA SANTIAGO","LIMON INDANZA","0","0","0","0","0"
"2019","MORONA SANTIAGO","LOGRONO","0","1","0","0","1"
"2019","MORONA SANTIAGO","MORONA","5","0","0","0","5"
"2019","MORONA SANTIAGO","PABLO SEXTO","0","0","0","0","0"
"2019","MORONA SANTIAGO","PALORA","0","0","0","0","0"
"2019","MORONA SANTIAGO","SAN JUAN BOSCO","0","0","0","0","0"
"2019","MORONA SANTIAGO","SANTIAGO","0","0","0","0","0"
"2019","MORONA SANTIAGO","SUCUA","1","0","0","0","1"
"2019","MORONA SANTIAGO","TAISHA","1","1","0","0","2"
"2019","MORONA SANTIAGO","TIWINTZA","0","0","0","0","0"
"2019","NAPO","ARCHIDONA","0","0","0","0","0"
"2019","NAPO","CARLOS JULIO AROSEMENA TOLA","0","0","0","0","0"
"2019","NAPO","EL CHACO","0","0","0","0","0"
"2019","NAPO","QUIJOS","0","0","0","0","0"
"2019","NAPO","TENA","0","0","2","0","2"
"2019","ORELLANA","AGUARICO","0","0","0","0","0"
"2019","ORELLANA","LA JOYA DE LOS SACHAS","4","0","0","0","4"
"2019","ORELLANA","LORETO","1","0","0","0","1"
"2019","ORELLANA","ORELLANA","2","1","1","0","4"
"2019","PASTAZA","ARAJUNO","1","0","0","0","1"
"2019","PASTAZA","MERA","1","0","0","0","1"
"2019","PASTAZA","PASTAZA","4","1","2","0","7"
"2019","PASTAZA","SANTA CLARA","0","0","0","0","0"
"2019","PICHINCHA","CAYAMBE","3","0","1","0","4"
"2019","PICHINCHA","MEJIA","1","0","2","0","3"
"2019","PICHINCHA","PEDRO MONCAYO","1","1","1","0","3"
"2019","PICHINCHA","PEDRO VICENTE MALDONADO","3","0","0","0","3"
"2019","PICHINCHA","PUERTO QUITO","3","0","0","0","3"
"2019","PICHINCHA","QUITO","42","8","85","0","135"
"2019","PICHINCHA","RUMINAHUI","2","0","1","0","3"
"2019","PICHINCHA","SAN MIGUEL DE LOS BANCOS","1","2","0","0","3"
"2019","SANTA ELENA","LA LIBERTAD","1","0","0","0","1"
"2019","SANTA ELENA","SALINAS","2","0","0","0","2"
"2019","SANTA ELENA","SANTA ELENA","4","1","0","0","5"
"2019","SANTO DOMINGO DE LOS TSÁCHILAS","LA CONCORDIA","1","0","2","0","3"
"2019","SANTO DOMINGO DE LOS TSÁCHILAS","SANTO DOMINGO","14","1","8","1","24"
"2019","SUCUMBÍOS","CASCALES","0","0","1","0","1"
"2019","SUCUMBÍOS","CUYABENO","0","1","0","0","1"
"2019","SUCUMBÍOS","GONZALO PIZARRO","0","0","0","0","0"
"2019","SUCUMBÍOS","LAGO AGRIO","19","1","2","0","22"
"2019","SUCUMBÍOS","PUTUMAYO","3","0","0","0","3"
"2019","SUCUMBÍOS","SHUSHUFINDI","1","1","1","0","3"
"2019","SUCUMBÍOS","SUCUMBIOS","0","0","0","0","0"
"2019","TUNGURAHUA","AMBATO","10","1","3","0","14"
"2019","TUNGURAHUA","BANOS DE AGUA SANTA","1","0","0","0","1"
"2019","TUNGURAHUA","CEVALLOS","0","0","0","0","0"
"2019","TUNGURAHUA","MOCHA","0","0","0","0","0"
"2019","TUNGURAHUA","PATATE","0","0","0","0","0"
"2019","TUNGURAHUA","QUERO","0","0","0","0","0"
"2019","TUNGURAHUA","SAN PEDRO DE PELILEO","2","0","0","0","2"
"2019","TUNGURAHUA","SANTIAGO DE PILLARO","0","0","0","0","0"
"2019","TUNGURAHUA","TISALEO","0","0","0","0","0"
"2019","ZAMORA CHINCHIPE","CENTINELA DEL CONDOR","0","0","0","0","0"
"2019","ZAMORA CHINCHIPE","CHINCHIPE","0","0","0","0","0"
"2019","ZAMORA CHINCHIPE","EL PANGUI","0","0","0","0","0"
"2019","ZAMORA CHINCHIPE","NANGARITZA","0","0","0","0","0"
"2019","ZAMORA CHINCHIPE","PALANDA","0","0","0","0","0"
"2019","ZAMORA CHINCHIPE","PAQUISHA","0","0","1","0","1"
"2019","ZAMORA CHINCHIPE","TACUAMBI","0","0","0","0","0"
"2019","ZAMORA CHINCHIPE","YANTZAZA (YANZATZA)","0","0","1","0","1"
"2019","ZAMORA CHINCHIPE","ZAMORA","0","0","0","0","0"
"2019","ZONAS NO DELIMITADAS","EL PIEDRERO","7","0","1","0","8"
"2019","ZONAS NO DELIMITADAS","LAS GOLONDRINAS","1","0","0","0","1"
"2019","ZONAS NO DELIMITADAS","MANGA DEL CURA","1","0","0","0","1"
"2019",".TOTAL","","893","62","226","6","1,187"
